************
****1111****
****1111****
****1111****
****1111****
****1111****
************
************
************
************
************
************
************
******0*****
